definitions = "definition.csv"
provinces = "provinces.png"
positions = "positions.txt"
rivers = "rivers.png"
topology = "heightmap.heightmap"
adjacencies = "adjacencies.csv"
areas = "areas.txt"
regions = "regions.txt"
ports = "ports.csv"
climate = "climate.txt"

#Seazones, list:
sea_zones = LIST { 1 7 8 9 10 11 19 20 21 22 23 24 25 26 31 32 33 34 35 36 37 
				   38 39 40 41 47 48 49 50 51 52 53 54 55 56 57 58 59 60 61 62 
				   63 64 65 66 67 68 69 70 71 72 73 74 75 76 77 78 79 91 92 93 
				   94 95 96 97 98 99 100 101 102 103 104 105 106 107 108 109 110 
				   111 112 113 114 115 116 117 118 119 120 121 122 123 124 125 
				   126 127 128 129 130 131 132 133 134 135 136 137 138 139 140 
				   141 142 143 144 145 146 147 148 149 150 151 152 153 154 155 
				   156 157 158 159 160 161 162 163 164 165 166 167 168 169 170 
				   171 172 173 174 175 176 177 178 179 180 181 182 183 184 185 
				   186 187 188 189 190 191 192 193 194 195 196 197 198 199 200 
				   201 202 203 204 205 206 207 208 209 210 211 212 213 214 215 
				   216 217 218 219 220 221 222 223 224 348 349 350 351 352 511 
				   237 238 239 241 313 414 436 964 965 966 967 968 969 970 971
				   972 973 974 975 976 977 978 979 980 981 982 983 984 985 986
				   987 988 989 990 991 992 993 994 995 996 997 998 999 1000}
impassable_terrain = LIST { 4 2 226 236 240 242 243 244 245 338 334 335 336 337
					        250 251 252 253 254 255 256 257 258 557 559 339 342
							259 260 261 262 323 324 325 326 327 328 329 330 331 
							332 333 963 }  
lakes = LIST { 225 249 248 247 246 343 340 341 344 345 346 347 558 }



