definitions = "definition.csv"
provinces = "provinces.png"
positions = "positions.txt"
rivers = "rivers.png"
topology = "heightmap.heightmap"
adjacencies = "adjacencies.csv"
areas = "areas.txt"
regions = "regions.txt"
ports = "ports.csv"
climate = "climate.txt"

#Seazones, list:
sea_zones = LIST { 21 236 237 238 239 240 241 242 243 244 245 246 247 248 249 250 251 252 253 254 255 256 257 258 259 
				   260 261 262 263 264 265 266 267 268 269 270 271 272 273 274 275 276 277 278 279 280 281 282 283 284 
				   285 286 287 288 289 290 291 292 293 294 295 296 297 298 299 300 301 302 303 304 305 306 307 308 309
				   311 312 313 314 315 316 317 318 319 320 321 322 323 324 325 326 327 328 329 330 331 332 333 334 335 
				   336 337 338 339 340 341 342 343 344 345 346 347 348 349 350 351 352 353 354 355 356 357 358 359 360 
				   361 362 363 364 365 366 367 368 369 370 371 372 373 374 375 376 377 378 379 380 381 382 383 384 385 
				   386 387 388 389 390 391 392 393 394 395 396 397 398 399 400 401 402 403 404 405 406 407 408 409 410 
				   412 413 414 415 416 417 418 419 420 506 760 1688 1689 1690 1691 1692 1693 1694 1695 1696 1697 1698 
				   1699 1700 1701 1702 1703 1704 1705 1706 1707 1708 1709 1710 1711 1712 1713 1714 1715 1716 1717 1718 
				   1719 1720 1721 1722 1723 1724 1725 1726 1727 1741 2088 2089 2090 2091 2092 2093 2108 2109 2110 2111
				   2112 2113 2114 2115 2116 2117 2118 2119 2120 2121 2122 2123 2124 2125 2126 2127 2128 2129 2130 2131
				   2132 2133 2134 2135 2136 2137 2138 2139 2140 2141 2142 2143 2144 2145 2146 2147 2148 2149 2150 2151
				   2152 2153 2154 2155 2156 2157 2158 2159 2160 2161 2681 2682 2683 2684 2685 2686 2687 2266 2726 103 153 
				   2727 2725 2724 2719 2721 2722 2479 2524 2473 2711 2712 2688 2692 2693 2723 2569 2339 2500 2521 2568 
				   2665 2667 2668 2672 2673 2674 2675 2676 2677 2678 2679 2733 2734 2735 2736 2737 2738 2739 2740 2741 
				   2742 2743 2744 2745 2774 2775 2776 2777 2778 2779 2780 2781 2782 2783 2784 2785 2786 2787 2788 2789 
				   2790 2791 2792 2793 2794 2795 2796 2797 2798 2799 2800 2801 2802 2803 2804 2805 2806 2807 2808 2809
				   2810 2811 2812 2813 2814 2815 2816 2817 2818 2819 2820 2821 2822 2823 2824 2825 2826 2827 2828 2829 
				   2830 104 3216 2916 3283 3284 3285 3286 3287 3288 3289 3290 3291 3292 3293 3294 3295 3296 3297 3298 
				   3299 3300 3301 3302 3303 3304 3305 3306 3307 3308 3309 3310 3311 3312 3313 3314 3315 3316 3317 3318 
				   3319 3320 3321 3322 3323 3324 3325 3326 3327 3328 3329 3330 3331 3332 3333 3334 3335 3336 3337 3338 
				   3339 3340 3351 3352 3353 3354 3355 3356 3357 3358 3359 3360 3697 3698 3699 3700 3701 3702 3703 3704 
				   3705 3706 3707 3708 3709 3710 3711 3712 3713 3714 3715 3716 3717 3718 3719 3720 3721 3722 3723 3724 
				   3725 3726 3727 3728 3729 3730 3731 3732 3733 3734 3735 3736 3737 3738 3739 3740 3741 3742 3743 3744 
				   3745 3746 3747 3748 3749 3750 3751 3752 3753 3754 3755 3756 3757 3758 3759 3760 3761 3762 3763 3764 
				   3765 3766 3767 3768 3769 3770 3771 3772 3773 3774 3775 3776 3777 3778 3779 3780 3781 3782 3783 3784 
				   3785 3786 3787 3788 3789 3790 3791 3792 3793 3794 3795 3796 3797 3798 3799 3800 3801 3802 3803 3804 
				   3805 3806 3807 3808 3809 3810 3967 3963 3965 137 4583 4584 4585 4586 4587 4588 4589 4590 4591 4592 
				   4593 4594 4595 4596 4597 4598 4599 4600 4601 4602 4603 4604 4605 4606 4607 4608 4609 4610 4611 4612 
				   4613 4614 4615 4616 4617 4618 4619 4620 4621 4622 4623 4624 4625 4626 4627 4628 4629 4630 4631 4632 
				   4633 4634 4635 4636 4637 4638 4639 4640 4641 4642 4643 4644 4645 4646 4647 4648 4649 4650 4651 4652 
				   4653 4654 4655 4656 4657 4658 4659 4660 4661 4662 4663 4664 4665 4666 4667 4668 4669 4670 4671 4672 
				   4673 4674 4675 4676 4677 4678 4679 4680 4681 4682 4683 4684 4685 4686 4687 4688 4689 4690 }
impassable_terrain = LIST { 3 4 5 6 7 9 11 12 13 14 16 17 18 19 20 24 25 26 27 28 29 30 31 32 33 34 35 36 37 38
							39 40 41 42 43 44 45 46 47 48 49 50 51 52 53 54 55 56 57 58 59 60 61 62 63 64 65 66 67 68 
							69 70 71 72 73 74 75 76 77 78 79 80 81 82 83 84 85 86 87 88 89 90 91 92 94 95 96 97 98 
							99 100 101 102 105 107 108 109 110 111 112 113 114 115 116 117 118 120 121
							122 123 124 125 126 127 128 129 130 131 132 133 134 135 136 138 139 140 141 142 143 144
							145 146 147 148 149 150 151 152 154 155 156 157 158 159 160 161 162 163 164 165 166 167 
							168 169 170 171 172 173 174 175 176 177 178 179 180 1551 1552 1553 1554 1555 1556 1735 1736 
							1737 1738 1739 1740 1742 1743 1744 1745 1746 1747 1748 1749 1750 1751 1752 1753 1754 1755 
							1756 1757 1758 1759 1760 1761 1762 1881 2094 2095 2096 2097 2098 2099 2181 2182 2183 2184 
							2186 2187 2188 2189 2190 2191 2192 2193 2194 2195 2196 2197 2198 2199 2200 2201 2202 
							2203 2204 2205 2206 2207 2208 2209 2210 2211 2212 2213 2214 2215 2216 2217 2218 2219 2220
							2222 2223 2224 2226 2227 2228 2231 2232 2233 2234 2235 2236 2237 2238 
							2239 2240 2241 2242 2243 2244 2245 2246 2247 2248 2249 2250 2251 2252 2253 2254 2255 2256 
							2257 2258 2259 2260 2261 2262 2263 2264 2265 2267 2268 2269 2270 2271 2272 2274 
							2275 2276 2277 2278 2279 2280 2281 2282 2283 2284 2285 2286 2287 2288 2289 2290 2560 
							2728 2553 2831 2832 2833 2834 2835 2836 2837 2838 2839 2840 2841 2842 2843 2844 2845
							2846 2847 2848 2849 2850 2851 2852 2853 2854 2855 2856 2857 2858 2859 2860 2861 2862 2863 
							2864 2865 2866 2867 2868 2869 2870 2871 2872 2873 2874 2875 2876 2877 2878 2879 2880 2881
							2882 2883 2884 2885 2886 2887 2888 2889 2890 2891 2892 2893 2894 2895 2896 2897 2898 2899 
							2900 2901 2902 2903 2904 2905 2906 2907 2908 2909 2910 2911 2912 2913 2914 2915 2917 
							2918 2919 2920 2921 2922 2923 2924 2925 2926 2927 2928 2929 2930 2931 2932 2933 2934 2935 
							2936 2937 2938 3371 3372 3373 3374 3375 3376 3377 3378 3379 3380 3381 3382 3383 3384 3385 
							3386 3387 3388 3389 3390 3391 3392 3393 3394 3395 3396 3397 3398 3399 3400 3401 3402 3403 
							3404 3405 3406 3407 3408 3409 3410 3411 3412 3413 3414 3415 3416 3417 3418 3419 3420 3421 
							3422 3826 3827 3828 3829 3830 3831 3832 3833 3834 3835 3836 3837 3838 3839 3840 3841 3842 
							3843 3844 3845 3846 3847 3848 3849 3850 3851 3852 3853 3854 3855 3856 3857 3858 3859 3860 
							3861 3862 3863 3864 3865 3866 3867 3868 3869 3870 3871 3872 3873 3874 3875 3876 3877 3878 
							3879 3880 3881 3882 3883 3884 3885 3886 3887 3888 3889 3890 3891 3892 3893 3894 3895 3896 
							3897 3898 3899 3900 3901 3902 3903 3904 3905 3906 3907 3908 3909 3910 3911 3912 3913 3914 
							3915 3916 3917 3918 3919 3920 3921 3922 3923 3924 3925 3926 3927 3928 3929 3930 3931 3932 
							3933 3934 3935 3936 3937 3938 3939 3940 3941 3942 3943 3944 3945 3946 3947 3948 3949 3950
							3951 3952 3953 3954 3955 3956 3957 3958 3959 3960 3961 3962 3964 3966 3968 
							3969 3970 3971 3972 3973 3974 3975 3976 3977 3978 3979 3980 3981 3982 3983 3984 3985 3986 
							3987 3988 3989 3990 3991 3992 3993 3994 3995 3996 3997 }  
wasteland = LIST { 1 2 119 106 93 3694 3695 3696 }
lakes = LIST { 181 182 183 184 185 186 187 188 189 190 191 192 193 194 195 196 197 198 199 200 201 202 203 204 205 206 
			   207 208 209 210 211 212 213 214 215 216 217 218 219 220 221 222 223 234 235 310 411 1731 1732 1733 1734 
			   2164 2165 2166 2167 2168 2169 2170 2171 2172 2173 2746 2747 2748 2749 2750 2751 2752 2753 2754 2755 2756 
			   2757 2758 2759 2760 2761 2762 2763 2764 2765 2766 2767 2768 2769 2770 2771 2772 2773 3341 3342 3343 3344 
			   3345 3346 3347 3348 3349 3350 3811 3812 3813 3814 3815 3816 3817 3818 3819 3820 3821 3822 3823 3824 3825 
			   4576 }



